[console_scripts]
analyze-logs=tools.analyze_logs:main
assemble-training-stats=scope._instantiate:assemble_training_stats
check-quads-for-sources=tools.generate_features_slurm:check_quads_for_sources
combine-preds=tools.combine_preds:main
combine-preds-slurm=tools.combine_preds_slurm:main
create-inference-script=scope._instantiate:create_inference_script
create-training-script=scope._instantiate:create_training_script
generate-features=tools.generate_features:main
generate-features-job-submission=tools.generate_features_job_submission:main
generate-features-slurm=tools.generate_features_slurm:main
get-quad-ids=tools.get_quad_ids:main
post-taxonomy=tools.taxonomy:main
run-inference=tools.inference:main
run-inference-job-submission=tools.run_inference_job_submission:main
run-inference-slurm=tools.run_inference_slurm:main
run-scope-local=tools.run_scope_local:main
scope-develop=scope._instantiate:develop
scope-doc=scope._instantiate:doc
scope-download-classification=tools.scope_download_classification:main
scope-initialize=scope.__init__:initialize
scope-lint=scope.scope_class:Scope.lint
scope-manage-annotation=tools.scope_manage_annotation:main
scope-test=scope._instantiate:test
scope-test-limited=scope._instantiate:test_limited
scope-train=scope._instantiate:train
scope-upload-classification=tools.scope_upload_classification:main
select-fritz-sample=scope._instantiate:select_fritz_sample
train-algorithm-job-submission=tools.train_algorithm_job_submission:main
train-algorithm-slurm=tools.train_algorithm_slurm:main

